0000000000000000000000000
0000000000011100000000000
0002000000000000000000000
0021000000000000000000000
0002000000000000000000000
0000000000000000000000000
0000000000000000000000000
0000000000000212000000000
0000000000000020000000000
0000000000000000000000001
0000000000000000000000000
0000000000000000000000000
0000000000000000000000000
0000000000000000000000000
1111111111111111110000000
