0000000000000000002222221
0000000000000000000000001
0000000000000000000000001
0000000000011111111110001
0000000000011111111110021
0000000000011111111110021
0000000000011111111110001
0000000000011111111112001
0000000000022222222212001
0000000000000002222212001
0000000000020000222222001
0000000000022200000000001
0000000000011111111111111
0000000000011111111111111
1111111000011111111111111
